20 20
********************
* * *  *  *     *  *
* * *    **    * * *
* *       *
*   * *       * * *
*    * *  
* **   *  *    *   *
*    *  * *  * * * *
*      **        *
**  * *            *
* * *    *     * * *
*          
* * *  * **    * * *
* *    *    
* *  **    *   *
*     *    * *  *
* **   * **    * * *
*    *  * *   
*    *   **    *   *
********************
1 1 15 15
